#####################################
# #       #             #     #     #
# ### ### # ########### ### # ##### #
# #   # #   #   #   #   #   #       #
# # ###A##### # # # # ### ###########
#   #   #     #   # # #   #         #
####### # ### ####### # ### ####### #
#       # #   #       # #       #   #
# ####### # # # ####### # ##### # # #
#       # # # #   #       #   # # # #
# ##### # # ##### ######### # ### # #
#     #   #                 #     #B#
#####################################
