#####################################
# #   #     #A        #     #       #
# # # # # # ####### # ### # ####### #
# # #   # #         #     # #       #
# ##### # ################# # #######
#     # #       #   #     # #   #   #
##### ##### ### ### # ### # # # # # #
#   #     #   # #   #  B# # # #   # #
# # ##### ##### # # ### # # ####### #
# #     # #   # # #   # # # #       #
# ### ### # # # # ##### # # # ##### #
#   #       #   #       #     #     #
#####################################
