#####################################
# #   #           #                 #
# ### # ####### # # # ############# #
#   #   #     # #   # #     #     # #
### ##### ### ####### # ##### ### # #
# #       # #  A  #   #       #   # #
# ######### ##### # ####### ### ### #
#               ###       # # # #   #
# ### ### ####### ####### # # # # ###
# # # #   #     #B#   #   # # #   # #
# # # ##### ### # # # # ### # ##### #
#   #         #     #   #           #
#####################################
